****************
*         * E  *
*    *    *    *
*    *    *   **
*    *    *    *
*    *    * *  *
*S   *         *
****************